NO ./textures/wall1.xpm

C 100,100,200
F 25,100,50

SO ./textures/wall2.xpm

WE ./textures/wall3.xpm
EA ./textures/wall4.xpm



111111111111111111111
100000000000000000001
100000100000001000001
100001010000010100001
100010001111100010001
100010000101000010001
100010010000010010001
100010010010010010001
1001110001S1000111001
100010000000000010001
100001100000001100001
100000011111110000001
100000000000000000001
111111111111111111111
