NO ./textures/kitty_est.xpm
SO ./textures/south.xpm
WE ./textures/west.xpm
EA ./textures/east.xpm


C 200,255,255
F 100,00000,50
C 255,255,255

11111111111
10001110001
10000000001
10000000001
10000N00001
10000000001
10000000001
11111111111