NO ./textures/kitty_est.xpm
SO ./textures/south.xpm
EA ./textures/east.xpm
WE ./textures/west.xpm

F 220,100,0
C 205,56,0

 11111111
1000000001
1000100001
10010 0001
100N100001
1000000001
 11111111
