NO ./textures/kitty_est.xpm
SO ./textures/south.xpm
EA ./textures/east.xpm
WE ./textures/west.xpm

C 200,255,255
F 220,0,0

11111111111
10001110001
10000000001
10000000001
10000N00011
10000000001
10000000001
11111111111