NO ./textures/kitty_est.xpm
SO ./textures/south.xpm
EA ./textures/east.xpm
WE ./textures/west.xpm

C 200,255,255
F 220,0,0
1111111111111111111111111
1000000000000000000000001
1000000001110000000000001
1000000001 10000000000001
100000000111W000000000001
1000000000000000000111001
10000000000000000001 1001
1111111111111111111111111