NO ./textures/kitty_nord.xpm
SO ./textures/kitty_sud.xpm
EA ./textures/kitty_est.xpm
WE ./textures/kitty_ouest.xpm

C 173,216,230
F 211,211,211
    1111111111111111111111111
    1000000000000000000000001
    1000000000000000000011111
1111100000000000000000001
100000000000W000000000001
1000000000000000000000001
1000000000000000000000001
1111111111111111111111111