NO ./textures/kitty_nord.xpm
SO ./textures/kitty_sud.xpm
EA ./textures/kitty_est.xpm
WE ./textures/kitty_ouest.xpm

C 173,216,230
F 211,211,211

111111111
1000N0001
111111111