NO ./textures/kitty_est.xpm
SO ./textures/south.xpm
EA ./textures/east.xpm
WE ./textures/west.xpm

C 200,255,255
F 220,0,0

111111111
1000N0001
111111111