NO ./textures/kitty_nord.xpm
SO ./textures/kitty_sud.xpm
EA ./textures/kitty_est.xpm
WE ./textures/kitty_ouest.xpm

C 173,216,230
F 211,211,211

11111
10001
1N001
11111